R  400 300
NO ./textures/redbrick.xpm
SO ./textures/wood.xpm
WE ./textures/metal.xpm
EA ./textures/colorstone.xpm
S ./textures/barrel.xpm
F 220,100,0
C 225,30,0
  1111111111111111111111111
  1101110111101100000111001111111
11100000001100000111011111111111
11110111111111011100000010000001
11110111111111011101010000200001
11000000111111011100000020001111
100200000010100001100002200011
10020000000000000000000000001
11000001110101011111010N0000111
11110111 1110101 101111010001
11111111 1111111 1111111111111
